1111111111111111
1000C00010000001
1000000011110001
1010000000000001
10P0001100000001
100111100000E001
1111111111111111