1111111111
1000000001
1000E000E1
1P000C0001
1111111111