1111111111111111
1000C00010000001
1000000011110001
10100C0000000001
10P0001100C00001
100111100000E001
1111111111111111